10 15 13 1
0 0 0 0 0 0 0 0 0 0 0 1 1 1 1
0 1 1 1 1 1 1 1 5 1 1 1 1 1 1
0 1 1 1 1 0 0 0 0 0 0 0 1 1 1
0 1 1 6 1 0 0 0 0 0 0 0 0 0 0
0 1 1 1 1 0 0 0 0 0 0 0 0 0 0
0 0 0 1 1 1 4 1 1 1 1 1 1 0 0
0 0 0 0 0 0 0 0 0 0 1 1 1 1 5
1 1 1 0 0 0 0 0 0 0 1 1 1 1 1
1 9 1 1 1 1 1 1 1 1 1 1 1 0 0
1 1 1 1 0 0 0 0 0 0 0 0 0 0 0
8 1 2 1 6 1 5
3 3 2 8 5 8 6
6 5 2 8 5 8 6 
14 6 2 8 5 8 6
