5 15 1 1
1 1 1 1 0 0 0 1 0 0 0 1 1 1 1
1 1 1 1 0 0 0 1 0 0 0 1 1 7 1
1 1 1 1 1 1 1 1 1 1 1 1 1 1 1
0 0 0 0 0 0 1 9 1 0 0 0 0 0 0
0 0 0 0 0 0 1 1 1 0 0 0 0 0 0
13 1 2 1 2 1 12
