10 15 1 0
0 1 1 1 1 1 1 1 1 1 5 1 1 1 1
0 0 0 0 0 1 1 0 0 0 0 0 0 1 1
0 0 0 0 0 1 1 0 0 0 0 0 0 1 1
0 0 0 0 0 0 0 0 0 0 0 0 0 1 1
0 0 0 0 0 0 0 0 0 0 0 0 0 1 1
1 1 1 0 0 1 1 0 0 1 4 1 1 1 1
1 9 1 0 0 1 1 0 0 0 0 0 0 0 0
1 1 1 0 0 1 1 0 0 0 0 0 0 0 0
0 1 1 0 0 1 1 0 0 0 0 0 0 0 0
0 1 1 1 1 1 1 1 1 1 6 1 1 1 0
10 0 2 5 7 5 8
10 5 2 9 2 9 3 
10 9 2 9 2 9 3 
