8 13 3 6
0 7 0 0 0 0 0 0 0 0 1 1 1
7 1 7 0 0 8 8 1 0 0 1 9 1
0 7 0 0 0 0 0 0 0 0 1 1 1
0 0 0 0 0 0 0 0 0 0 0 0 0
0 0 0 0 0 0 0 0 0 0 0 0 0
0 0 1 1 1 0 0 0 1 1 1 0 0
0 0 1 1 1 1 1 1 1 7 1 0 0 
0 0 1 1 1 0 0 0 1 1 1 0 0
9 6 2 0 1 1 0
1 0 2 1 5 1 7
1 2 2 1 0 2 1
2 1 2 1 0 1 2
0 1 2 1 5 1 7
5 1 2 1 3 1 4
6 1 2 1 8 1 9
