10 15 1 1 
1 1 1 0 0 0 0 0 0 0 0 0 0 0 0
1 1 1 1 1 1 1 1 1 0 0 0 1 1 1
1 1 1 0 0 0 0 0 1 1 1 1 1 9 1
1 1 1 0 0 0 0 0 0 0 0 0 3 3 1
1 1 1 0 0 0 0 0 0 0 0 0 0 0 0
1 1 1 0 0 0 0 0 0 0 0 0 0 0 0
1 1 1 0 0 0 0 1 1 1 1 1 3 0 0
1 1 1 1 1 1 1 1 0 0 0 1 1 0 0
1 5 1 0 0 0 0 0 0 0 0 1 1 0 0
1 1 1 0 0 0 0 0 0 0 0 1 3 0 0
1 8 1 7 8
12 6 0 0 1 2 7
12 9 0 1 7 8 1 1 9
12 3 0 1 6 6 0
13 3 0 0 1 6 6
