10 15 2 2
0 1 1 1 1 1 1 0 0 0 0 0 0 0 0 
0 1 1 0 0 1 1 1 0 0 0 0 0 0 0
2 2 1 0 0 1 1 1 1 0 0 0 0 0 0 
2 2 0 0 0 0 0 1 1 1 0 0 0 0 0
2 2 0 0 0 0 0 0 1 1 1 0 0 0 0
2 1 1 1 0 0 0 0 0 1 1 7 0 0 0
0 1 9 1 0 0 0 0 0 0 1 1 1 1 1 
0 1 1 1 1 1 1 0 0 0 1 5 1 1 1
0 0 1 0 0 1 1 0 0 0 1 1 1 0 0 
0 0 1 0 0 1 1 1 1 1 1 1 1 0 0 
11 7 0 4 0 3 0 4 9 8 9 9 0
11 5 2 6 14 9 12
