10 15 8 2
0 0 0 0 0 0 0 0 0 0 0 0 1 1 1
0 0 1 1 1 1 1 1 1 1 0 0 1 1 1
0 0 1 1 1 0 0 4 1 1 0 0 1 1 1
0 0 1 1 1 0 0 1 1 1 0 0 0 0 0
0 0 1 4 1 0 0 7 1 4 0 0 0 0 0
0 0 1 1 1 0 0 1 1 1 0 0 0 0 0
1 1 1 1 0 0 0 1 1 1 0 0 5 1 1
1 5 0 0 0 0 0 0 0 0 0 0 1 1 1
0 0 0 0 0 0 0 0 0 0 0 0 1 9 1
0 0 0 0 0 0 0 0 0 0 0 0 1 1 1
7 2 2 1 5 1 6
9 4 2 1 5 1 6
7 4 2 1 13 7 13
12 6 2 6 10 6 11
3 4 2 1 5 1 6
1 7 2 1 10 1 11
