10 15 4 7
0 1 1 1 0 0 0 0 0 0 0 0 1 1 1
0 1 3 1 0 0 0 0 0 0 0 0 1 5 1
0 1 1 1 0 0 0 1 1 1 1 1 1 1 1
0 1 1 1 0 0 0 1 9 1 0 0 1 1 5
1 0 0 0 1 0 0 1 1 1 0 0 0 0 1
5 0 0 0 1 0 0 2 2 2 0 0 0 0 1
1 0 0 1 1 1 2 2 2 2 2 1 1 1 1
0 0 0 1 1 1 2 2 2 2 2 1 7 1 0
0 0 0 1 1 1 2 2 2 2 2 1 1 1 0
0 0 0 1 1 1 1 1 0 0 0 0 0 0 0
12 7 2 7 12 2 2
13 1 1 9 8 0 2 6 1 6 2
14 3 0 3 2 10 2 11 6 14 0
0 5 0 2 6 1 6 2 1 3 0
2 1 0 0 1 3 4
