9 14 10 5 
0 0 0 0 0 1 1 1 1 0 0 0 0 7 
0 0 0 0 0 1 1 5 1 1 1 0 0 1
0 0 0 0 1 1 1 1 1 1 1 0 0 1
1 1 1 1 1 1 1 1 0 0 1 1 1 1
1 1 1 0 0 0 1 0 0 0 1 1 0 0 
1 1 1 0 0 0 1 0 0 0 1 0 0 0
0 1 0 0 0 0 1 1 1 0 0 0 0 0 
0 3 0 0 0 0 1 9 1 0 0 0 0 0
0 0 0 0 0 0 1 1 1 0 0 0 0 0
7 1 0 2 3 2 3 3 0
13 0 2 3 12 5 10
1 7 0 0 2 4 3 7 9
