10 15 12 7
0 0 0 0 0 0 0 0 0 0 0 1 1 1 0
0 1 1 1 0 0 0 0 3 0 0 1 9 1 0
0 1 1 1 1 1 1 1 1 0 0 1 1 1 0
0 1 1 1 0 0 1 1 1 0 0 0 1 0 0
0 2 2 2 0 0 5 1 1 0 0 0 2 0 0
0 0 2 0 0 0 1 1 1 0 0 2 2 2 0
0 0 1 0 0 0 1 1 1 0 0 1 1 1 0
1 1 1 1 0 0 1 5 1 1 1 1 1 1 0
1 1 3 1 0 0 3 0 0 0 0 1 1 1 0
1 1 1 1 0 0 0 0 0 0 0 0 0 0 0
7 7 0 8 2 4 2 5 2 9 2 10 7 4 7 5 7 9 7 10 0
6 4 0 8 2 4 2 5 2 9 2 10 7 4 7 5 7 9 7 10 0
6 8 2 7 4 7 5 0 0
8 1 2 2 9 2 10 0 0
2 8 0 2 2 4 2 5 3 0 14 1 14 2 14
